Date,Month,Year,Graphing Label,Total Jobs (private and government),Private Sector (total),"Mining, Logging and Construction",Manufacturing (total),Manufacturing (durable goods),Manufacturing (non-durable goods),"Trade, Transportation, and Utilities (total)","Trade, Transportation, and Utilities (wholesale trade)","Trade, Transportation, and Utilities (retail trade)","Trade, Transportation, and Utilities (transportation, warehousing, and utilities)",Information,Financial Activities (total),Financial Activities (finance and insurance),Financial Activities (real estate and rental and leasing),Professional and Business Services (total),"Professional and Business Services (professional, scientific, and technical services)",Professional and Business Services (management of companies and enterprises),Professional and Business Services (administrative and support and waste management and remediation services),Education and Health Services (total),Education and Health Services (educational services),Education and Health Services (health care and social assistance),Leisure and Hospitality (total),"Leisure and Hospitality (arts, entertainment, and recreation)",Leisure and Hospitality (accommodation and food services),Other Services,Government (total),Government (federal),Government (state),Government (local)
1/1/2007 0:00,Jan,2007,7-Jan,2608300,2132200,190700,134900,72800,62100,478600,95100,302000,81500,50100,158800,111100,47700,396100,220100,20200,155800,370100,70500,299600,235500,38600,196900,117400,476100,125400,108800,241900
2/1/2007 0:00,Feb,2007,7-Feb,2601000,2125500,188000,134700,72600,62100,477700,95300,301100,81300,50100,158500,110800,47700,395700,220400,20300,155000,370400,70700,299700,233500,36700,196800,116900,475500,124900,108600,242000
3/1/2007 0:00,Mar,2007,7-Mar,2611900,2134600,191100,134700,72500,62200,479000,95300,302000,81700,50400,158200,110400,47800,397300,221000,20500,155800,372200,71300,300900,234500,37200,197300,117200,477300,124800,109000,243500
4/1/2007 0:00,Apr,2007,7-Apr,2606900,2129300,191100,134400,72400,62000,476900,95200,300900,80800,50500,157700,110000,47700,396600,220900,20500,155200,371900,70900,301000,233000,35900,197100,117200,477600,124800,109200,243600
5/1/2007 0:00,May,2007,7-May,2611600,2132400,191700,134300,72200,62100,477700,95100,301400,81200,50900,157700,110000,47700,397200,221400,20500,155300,373000,71500,301500,232700,36100,196600,117200,479200,124600,109800,244800
6/1/2007 0:00,Jun,2007,7-Jun,2610600,2132400,191600,134100,72100,62000,477300,94800,301300,81200,51200,157300,109700,47600,397200,221600,20600,155000,374300,71600,302700,232000,35300,196700,117400,478200,124700,108100,245400
7/1/2007 0:00,Jul,2007,7-Jul,2612600,2132900,191200,134000,72200,61800,476500,94800,300700,81000,51300,157200,109700,47500,397400,221700,20900,154800,374200,71200,303000,233200,35900,197300,117900,479700,124600,109300,245800
8/1/2007 0:00,Aug,2007,7-Aug,2612700,2131300,190700,133500,71800,61700,474500,94600,299400,80500,51800,156600,109200,47400,397400,221900,20800,154700,375100,71200,303900,234000,36200,197800,117700,481400,125000,109400,247000
9/1/2007 0:00,Sep,2007,7-Sep,2611700,2130700,189600,133100,71500,61600,473300,94500,298500,80300,51800,156200,108900,47300,398300,221700,21000,155600,376200,71500,304700,234400,36300,198100,117800,481000,124900,109300,246800
10/1/2007 0:00,Oct,2007,7-Oct,2611000,2128900,188800,133300,71800,61500,473700,94300,299200,80200,50200,155700,108400,47300,398700,222300,21000,155400,375600,71700,303900,234800,36500,198300,118100,482100,125200,109300,247600
11/1/2007 0:00,Nov,2007,7-Nov,2612600,2128800,187600,133000,71700,61300,473800,94300,299700,79800,50500,155200,107800,47400,399200,223000,21200,155000,376400,72400,304000,235000,35700,199300,118100,483800,125400,110000,248400
12/1/2007 0:00,Dec,2007,7-Dec,2615800,2131800,186600,133000,71800,61200,475000,94400,300600,80000,51000,155000,107800,47200,400100,223700,21300,155100,377300,72500,304800,235800,36600,199200,118000,484000,125500,109800,248700
1/1/2008 0:00,Jan,2008,8-Jan,2619300,2132900,187200,132600,71600,61000,473300,94300,299500,79500,50900,154300,107400,46900,400800,225200,21400,154200,379300,73500,305800,236800,36900,199900,117700,486400,125500,109600,251300
2/1/2008 0:00,Feb,2008,8-Feb,2619200,2132500,186700,132800,71600,61200,473000,94200,299300,79500,50800,154200,107300,46900,400200,225000,21500,153700,379600,73000,306600,237500,37400,200100,117700,486700,125800,109900,251000
3/1/2008 0:00,Mar,2008,8-Mar,2615200,2128900,185900,132000,71100,60900,471400,94500,298100,78800,50400,154000,107200,46800,399600,225000,21600,153000,380600,73300,307300,237600,36800,200800,117400,486300,126000,109900,250400
4/1/2008 0:00,Apr,2008,8-Apr,2615900,2128900,184300,131300,70800,60500,469200,93900,296700,78600,50600,153600,106900,46700,400100,225600,21400,153100,382000,73600,308400,239800,37000,202800,118000,487000,126300,110200,250500
5/1/2008 0:00,May,2008,8-May,2609600,2122300,182600,130900,70600,60300,467500,93600,295200,78700,50100,153000,106500,46500,398800,225400,21500,151900,382700,73800,308900,238700,37200,201500,118000,487300,126600,109500,251200
6/1/2008 0:00,Jun,2008,8-Jun,2602700,2116100,181200,130400,70300,60100,465900,93500,293700,78700,49400,152400,106200,46200,397800,225400,21400,151000,383500,74000,309500,237400,36800,200600,118100,486600,126900,109900,249800
7/1/2008 0:00,Jul,2008,8-Jul,2604500,2114000,179700,130100,70200,59900,465400,93100,293300,79000,49500,151800,105600,46200,399000,225900,21400,151700,384800,74500,310300,236100,36400,199700,117600,490500,127500,110600,252400
8/1/2008 0:00,Aug,2008,8-Aug,2601000,2108800,178600,129900,70200,59700,464200,92700,292400,79100,49100,151500,105600,45900,397600,225200,21600,150800,385700,74400,311300,234900,36100,198800,117300,492200,127600,110800,253800
9/1/2008 0:00,Sep,2008,8-Sep,2594300,2103600,177300,129200,69800,59400,461800,92400,290800,78600,49100,150700,104900,45800,397400,225800,21600,150000,387500,75300,312200,233200,35200,198000,117400,490700,127900,111200,251600
10/1/2008 0:00,Oct,2008,8-Oct,2588800,2098100,175300,128100,69200,58900,459900,92000,289400,78500,48800,150400,104800,45600,395200,225500,21400,148300,388700,74800,313900,234900,35900,199000,116800,490700,128100,111400,251200
11/1/2008 0:00,Nov,2008,8-Nov,2579600,2088500,172800,127500,68800,58700,455500,91300,285700,78500,49100,149600,104300,45300,393800,225600,21300,146900,389100,74400,314700,234500,35700,198800,116600,491100,128600,111600,250900
12/1/2008 0:00,Dec,2008,8-Dec,2570800,2078900,169500,126500,68300,58200,453000,90600,283600,78800,48500,149300,104100,45200,391200,225600,21300,144300,390200,75300,314900,234400,36000,198400,116300,491900,129200,111600,251100
1/1/2009 0:00,Jan,2009,9-Jan,2557700,2066900,166000,125400,67600,57800,449400,90200,281700,77500,47400,148000,103800,44200,390200,225900,21300,143000,391600,75700,315900,232800,35300,197500,116100,490800,129200,110400,251200
2/1/2009 0:00,Feb,2009,9-Feb,2548500,2056500,163900,124400,67000,57400,446900,89800,280000,77100,47100,147500,103600,43900,387600,225000,21100,141500,392100,75200,316900,231300,34900,196400,115700,492000,129600,110300,252100
3/1/2009 0:00,Mar,2009,9-Mar,2537000,2044700,161100,123200,66400,56800,443800,88800,278400,76600,47300,146200,103000,43200,385000,224400,21000,139600,392500,75100,317400,230200,34800,195400,115400,492300,129700,111400,251200
4/1/2009 0:00,Apr,2009,9-Apr,2530200,2036200,158200,122100,65900,56200,440400,88200,276500,75700,46300,146300,103200,43100,384000,223800,21000,139200,393600,74800,318800,230300,35200,195100,115000,494000,130900,111400,251700
5/1/2009 0:00,May,2009,9-May,2531600,2036800,156600,121400,65700,55700,440500,87600,277100,75800,45800,146200,103100,43100,383800,223700,21100,139000,394400,75100,319300,232900,36800,196100,115200,494800,131100,110200,253500
6/1/2009 0:00,Jun,2009,9-Jun,2528600,2034000,155200,120800,65200,55600,439600,87100,276800,75700,46100,145700,102800,42900,383500,223600,21000,138900,395500,75300,320200,232000,36100,195900,115600,494600,131300,110800,252500
7/1/2009 0:00,Jul,2009,9-Jul,2519500,2024200,153700,119800,64400,55400,438000,86700,276000,75300,45300,145100,102200,42900,381600,223000,20400,138200,394200,73900,320300,231600,36100,195500,114900,495300,132000,111700,251600
8/1/2009 0:00,Aug,2009,9-Aug,2517300,2021000,151800,119500,64600,54900,437100,86700,275400,75000,45300,144700,102000,42700,382300,223200,20400,138700,395300,74600,320700,230400,35700,194700,114600,496300,132500,112200,251600
9/1/2009 0:00,Sep,2009,9-Sep,2511500,2018200,150100,119600,64300,55300,437000,86300,275400,75300,44600,144600,101900,42700,380700,222400,20400,137900,395600,75000,320600,231100,35700,195400,114900,493300,132800,112100,248400
10/1/2009 0:00,Oct,2009,9-Oct,2511400,2012900,148700,119600,64400,55200,435300,86100,274300,74900,44200,144200,101400,42800,381200,222000,20500,138700,396500,74700,321800,228500,34900,193600,114700,498500,134000,114000,250500
11/1/2009 0:00,Nov,2009,9-Nov,2510300,2013000,147700,119400,64600,54800,436000,85900,275000,75100,43900,144400,101500,42900,381500,222000,20700,138800,397100,74700,322400,228100,34900,193200,114900,497300,134100,112900,250300
12/1/2009 0:00,Dec,2009,9-Dec,2506300,2008400,146900,119200,64200,55000,433300,85600,273900,73800,43700,143900,101300,42600,381200,221700,20700,138800,397700,75000,322700,227800,34900,192900,114700,497900,134400,112900,250600
1/1/2010 0:00,Jan,2010,10-Jan,2506700,2008300,145500,118900,64000,54900,433400,85200,274100,74100,44100,143100,100700,42400,381900,221300,20200,140400,399200,76100,323100,228100,34900,193200,114100,498400,135800,112900,249700
2/1/2010 0:00,Feb,2010,10-Feb,2472400,1976700,138300,117000,62800,54200,428000,84600,269700,73700,44000,142600,100400,42200,378400,220700,20500,137200,392800,74300,318500,222800,33300,189500,112800,495700,135700,113000,247000
3/1/2010 0:00,Mar,2010,10-Mar,2507000,2007200,143600,117700,63100,54600,435100,85200,275100,74800,44700,142900,100500,42400,383300,222700,20800,139800,399100,75700,323400,226300,35000,191300,114500,499800,136100,114000,249700
4/1/2010 0:00,Apr,2010,10-Apr,2521700,2021200,146500,118300,63300,55000,438500,85500,276100,76900,44900,142900,100600,42300,386300,223400,21000,141900,400700,76500,324200,229300,35500,193800,113800,500500,137800,113000,249700
5/1/2010 0:00,May,2010,10-May,2530600,2022700,146400,117800,63000,54800,439200,85700,277100,76400,44600,143000,100800,42200,387000,223900,21100,142000,401300,76700,324600,229400,36200,193200,114000,507900,145600,113900,248400
6/1/2010 0:00,Jun,2010,10-Jun,2530600,2024600,145800,117600,63000,54600,439600,85600,277700,76300,45000,143400,101200,42200,388400,224800,21200,142400,401300,76600,324700,229400,35900,193500,114100,506000,143700,113100,249200
7/1/2010 0:00,Jul,2010,10-Jul,2528700,2024600,145300,117100,62600,54500,440100,85600,278200,76300,44000,143500,101500,42000,388300,224400,21400,142500,402200,76800,325400,230200,35700,194500,113900,504100,141900,113700,248500
8/1/2010 0:00,Aug,2010,10-Aug,2528300,2024800,145500,116500,62200,54300,439800,85500,278200,76100,42700,143400,101600,41800,388500,224800,21600,142100,403000,76800,326200,231300,35700,195600,114100,503500,140800,113900,248800
9/1/2010 0:00,Sep,2010,10-Sep,2527400,2026600,145400,116200,62000,54200,439000,85000,277900,76100,44000,143500,101800,41700,388800,225400,21900,141500,403500,77400,326100,232600,36100,196500,113600,500800,140000,113500,247300
10/1/2010 0:00,Oct,2010,10-Oct,2535100,2034400,145100,115600,61400,54200,441400,85700,279000,76700,43900,143900,102100,41800,393300,226400,22200,144700,403600,77100,326500,233400,35900,197500,114200,500700,140100,112900,247700
11/1/2010 0:00,Nov,2010,10-Nov,2532800,2029800,145600,114900,60800,54100,440800,85700,278900,76200,42200,144000,102300,41700,391200,226700,22500,142000,404400,77200,327200,232700,35400,197300,114000,503000,140400,113200,249400
12/1/2010 0:00,Dec,2010,10-Dec,2537600,2035400,144900,114600,60600,54000,441200,85800,279100,76300,43800,144700,102900,41800,393800,227300,22600,143900,405200,77200,328000,233300,35600,197700,113900,502200,141100,113400,247700
1/1/2011 0:00,Jan,2011,11-Jan,2535000,2031200,144300,116100,61900,54200,441600,86000,279200,76400,41900,143900,102200,41700,394100,227200,22900,144000,405900,77900,328000,229500,35700,193800,113900,503800,141500,113800,248500
2/1/2011 0:00,Feb,2011,11-Feb,2540000,2035500,144700,116300,62000,54300,441900,85700,279500,76700,42400,144000,102100,41900,394800,227400,23200,144200,406800,77900,328900,230700,35800,194900,113900,504500,142100,114000,248400
3/1/2011 0:00,Mar,2011,11-Mar,2544500,2038400,145000,116000,61900,54100,442600,85900,280000,76700,42000,143800,102100,41700,395600,227800,23200,144600,407200,78100,329100,232400,35900,196500,113800,506100,142600,113600,249900
4/1/2011 0:00,Apr,2011,11-Apr,2544000,2040600,145600,116100,62000,54100,442900,85800,280200,76900,41600,143800,101900,41900,396500,228600,23400,144500,407300,78100,329200,232900,36100,196800,113900,503400,143100,111700,248600
5/1/2011 0:00,May,2011,11-May,2541800,2038900,145100,115800,61900,53900,443100,85900,279900,77300,41000,143500,101600,41900,396700,228600,23500,144600,407800,77700,330100,232400,35300,197100,113500,502900,143900,111900,247100
6/1/2011 0:00,Jun,2011,11-Jun,2542300,2037100,144800,115400,61600,53800,443100,85800,280000,77300,40600,143000,101100,41900,397700,229100,23500,145100,406900,77300,329600,232200,35700,196500,113400,505200,144600,112400,248200
7/1/2011 0:00,Jul,2011,11-Jul,2554100,2046400,145300,115200,61600,53600,444000,86200,279700,78100,41100,142900,100900,42000,401300,230100,23900,147300,409100,77700,331400,234200,36100,198100,113300,507700,144900,112800,250000
8/1/2011 0:00,Aug,2011,11-Aug,2547300,2044400,144700,114900,61600,53300,445200,86100,280800,78300,37700,142500,100400,42100,401200,230200,24000,147000,410400,78700,331700,234700,36000,198700,113100,502900,146100,113100,243700
9/1/2011 0:00,Sep,2011,11-Sep,2553100,2048700,144000,114300,61400,52900,446200,86400,281800,78000,40300,142600,100300,42300,402500,230500,24100,147900,411100,78400,332700,235400,36300,199100,112300,504400,148500,112500,243400
10/1/2011 0:00,Oct,2011,11-Oct,2556700,2049900,144500,114200,61500,52700,445800,86000,281900,77900,40600,142700,100000,42700,403000,230900,24200,147900,411400,78400,333000,235200,36100,199100,112500,506800,147700,114000,245100
11/1/2011 0:00,Nov,2011,11-Nov,2554300,2053000,144600,113600,61200,52400,446300,85800,282600,77900,40800,142100,99400,42700,404500,231400,24400,148700,412000,78600,333400,236700,36900,199800,112400,501300,144700,111900,244700
12/1/2011 0:00,Dec,2011,11-Dec,2561700,2057200,145200,113500,61200,52300,447300,85800,283600,77900,40400,142200,99500,42700,405900,231900,24600,149400,412500,78600,333900,237600,36600,201000,112600,504500,144400,113200,246900
1/1/2012 0:00,Jan,2012,12-Jan,2568100,2065000,145600,113400,61100,52300,449000,85800,284500,78700,40400,143200,100300,42900,406800,232500,24700,149600,415500,79400,336100,238600,36600,202000,112500,503100,146900,111400,244800
2/1/2012 0:00,Feb,2012,12-Feb,2571100,2066400,145600,112600,60600,52000,450300,86100,285200,79000,40300,142800,99800,43000,406700,232300,24900,149500,416000,79700,336300,239900,36700,203200,112200,504700,146800,112100,245800
3/1/2012 0:00,Mar,2012,12-Mar,2578300,2073000,146100,112500,60400,52100,451800,86400,286100,79300,39900,142800,99500,43300,409100,233200,24900,151000,416800,79100,337700,241900,37300,204600,112100,505300,146800,111700,246800
4/1/2012 0:00,Apr,2012,12-Apr,2570800,2066400,144600,112200,60200,52000,450900,86300,284900,79700,38800,142300,99200,43100,406400,232700,25100,148600,417200,79400,337800,242000,37500,204500,112000,504400,146400,111600,246400
5/1/2012 0:00,May,2012,12-May,2570000,2067200,143400,111900,60000,51900,449800,86300,284200,79300,38900,142600,99300,43300,408900,234200,25200,149500,417500,79200,338300,242600,37600,205000,111600,502800,146200,110000,246600
6/1/2012 0:00,Jun,2012,12-Jun,2575500,2074400,144300,112200,60200,52000,450300,86600,284100,79600,40200,142600,99200,43400,409700,234000,25200,150500,418600,79100,339500,245000,38200,206800,111500,501100,146200,109800,245100
7/1/2012 0:00,Jul,2012,12-Jul,2575300,2074100,144400,112100,59700,52400,448600,86300,282800,79500,40200,143000,99500,43500,409600,233900,25300,150400,419500,79700,339800,245200,38100,207100,111500,501200,146700,109400,245100
8/1/2012 0:00,Aug,2012,12-Aug,2576400,2076800,144400,111400,59500,51900,448500,86200,282800,79500,40200,143200,99800,43400,411500,234200,25400,151900,419900,79600,340300,246300,38300,208000,111400,499600,146300,108000,245300
9/1/2012 0:00,Sep,2012,12-Sep,2584300,2081800,144900,110200,58500,51700,450400,86200,284400,79800,40100,143600,100000,43600,413200,234800,25600,152800,420400,79400,341000,247600,39100,208500,111400,502500,146100,110200,246200
10/1/2012 0:00,Oct,2012,12-Oct,2586800,2082800,145800,109600,58100,51500,450400,86200,284600,79600,39700,143700,100200,43500,413100,235100,25600,152400,421100,79900,341200,248300,39800,208500,111100,504000,146100,111400,246500
11/1/2012 0:00,Nov,2012,12-Nov,2585300,2082800,145600,109800,58200,51600,451200,86100,285400,79700,39700,144100,100600,43500,414200,235200,25800,153200,420300,79800,340500,247600,39300,208300,110300,502500,146000,110900,245600
12/1/2012 0:00,Dec,2012,12-Dec,2591200,2087500,146200,109700,58200,51500,450800,86100,285100,79600,40400,144200,100700,43500,414900,235200,25800,153900,422200,80100,342100,248400,39500,208900,110700,503700,145800,110900,247000
1/1/2013 0:00,Jan,2013,13-Jan,2598300,2094100,146900,109600,58200,51400,450900,86100,284900,79900,40200,145100,101400,43700,416900,235800,25700,155400,422800,79900,342900,251400,40700,210700,110300,504200,146100,111200,246900
2/1/2013 0:00,Feb,2013,13-Feb,2599500,2096500,146800,109600,58300,51300,451500,86100,285600,79800,39900,144600,101000,43600,418600,236400,25600,156600,423300,80000,343300,251900,40900,211000,110300,503000,145900,111300,245800
3/1/2013 0:00,Mar,2013,13-Mar,2602200,2098700,147400,109200,58100,51100,451100,86000,285200,79900,40000,144900,101200,43700,420200,236900,25700,157600,423800,80400,343400,252100,41300,210800,110000,503500,145700,110900,246900
4/1/2013 0:00,Apr,2013,13-Apr,2598600,2094600,147500,109000,57900,51100,450100,85800,284800,79500,39800,145200,101300,43900,415700,235400,26000,154300,424300,80400,343900,252200,41300,210900,110800,504000,145400,111400,247200
5/1/2013 0:00,May,2013,13-May,2598200,2094700,147400,108800,57700,51100,450800,85500,285400,79900,39200,145200,101400,43800,415500,235600,25900,154000,424600,80400,344200,252600,40700,211900,110600,503500,145100,111300,247100
6/1/2013 0:00,Jun,2013,13-Jun,2602800,2097500,147500,108500,57600,50900,450900,85400,285300,80200,39300,145300,101600,43700,416300,235700,25900,154700,424600,80300,344300,254600,41900,212700,110500,505300,144800,112900,247600
7/1/2013 0:00,Jul,2013,13-Jul,2603300,2098600,147600,108100,57300,50800,451400,85200,285900,80300,39500,145500,101700,43800,416000,236300,26000,153700,424800,80600,344200,255000,41900,213100,110700,504700,144400,111800,248500
8/1/2013 0:00,Aug,2013,13-Aug,2602500,2100500,147900,108000,57200,50800,451700,85000,286300,80400,39300,145300,101600,43700,417500,236900,26000,154600,425300,80600,344700,254900,41900,213000,110600,502000,144100,109400,248500
9/1/2013 0:00,Sep,2013,13-Sep,2605400,2103100,148100,107800,56900,50900,451700,85000,286100,80600,39600,145500,101700,43800,419000,238200,26000,154800,425700,80600,345100,254800,41400,213400,110900,502300,144000,110300,248000
10/1/2013 0:00,Oct,2013,13-Oct,2604000,2101600,147700,107300,56400,50900,451900,84900,286300,80700,39400,145100,101400,43700,417600,236200,25600,155800,426100,80400,345700,255900,41900,214000,110600,502400,143600,110400,248400
11/1/2013 0:00,Nov,2013,13-Nov,2607800,2105300,148000,107500,56300,51200,452000,84900,286300,80800,39700,145100,101400,43700,418600,237000,25500,156100,426200,80400,345800,257300,42800,214500,110900,502500,143300,110400,248800
12/1/2013 0:00,Dec,2013,13-Dec,2603800,2103600,147000,106800,55800,51000,452700,84900,286800,81000,39400,145000,101200,43800,418600,237800,25600,155200,426300,80400,345900,257300,42400,214900,110500,500200,143200,110600,246400
1/1/2014 0:00,Jan,2014,14-Jan,2608200,2106500,148700,106000,55700,50300,453300,84700,287400,81200,40600,144800,100800,44000,419700,238000,25500,156200,426200,80400,345800,256400,42200,214200,110800,501700,142900,110300,248500
2/1/2014 0:00,Feb,2014,14-Feb,2608000,2105800,148600,106000,55600,50400,452400,84600,287000,80800,39200,144600,100700,43900,421200,238500,25500,157200,426300,80300,346000,256700,42500,214200,110800,502200,142600,110700,248900
3/1/2014 0:00,Mar,2014,14-Mar,2609100,2108900,149300,105800,55400,50400,453800,84500,287600,81700,38800,144200,100100,44100,421400,238500,25600,157300,427500,80400,347100,257100,42700,214400,111000,500200,142500,110900,246800
4/1/2014 0:00,Apr,2014,14-Apr,2615700,2115300,150400,105700,55100,50600,454800,84500,288200,82100,38900,144600,100300,44300,423000,239500,25300,158200,427800,80300,347500,258800,43000,215800,111300,500400,142900,110300,247200
5/1/2014 0:00,May,2014,14-May,2620600,2121200,151400,105700,55100,50600,454900,84600,287900,82400,39200,144700,100500,44200,424500,239600,25300,159600,428800,80600,348200,260500,43500,217000,111500,499400,142800,108700,247900
6/1/2014 0:00,Jun,2014,14-Jun,2626200,2122300,151800,105600,55000,50600,455800,84400,288800,82600,38300,144600,100300,44300,424200,239900,25400,158900,430000,81000,349000,260000,43500,216500,112000,503900,142600,113500,247800
7/1/2014 0:00,Jul,2014,14-Jul,2621900,2122600,151600,105300,55000,50300,456000,84600,289200,82200,38600,144600,100400,44200,424500,239800,25300,159400,430100,80000,350100,260000,43500,216500,111900,499300,142600,110700,246000
8/1/2014 0:00,Aug,2014,14-Aug,2630400,2128100,152000,105400,54900,50500,456900,84600,289500,82800,39400,144900,100600,44300,424100,239700,25300,159100,431900,80900,351000,261500,44500,217000,112000,502300,143200,110300,248800
9/1/2014 0:00,Sep,2014,14-Sep,2634200,2130200,152200,105500,55000,50500,456400,84500,288900,83000,38700,144700,100400,44300,425000,240400,25100,159500,432500,81200,351300,262600,45100,217500,112600,504000,143300,110800,249900
10/1/2014 0:00,Oct,2014,14-Oct,2636300,2133900,152100,105800,55200,50600,457100,84500,289300,83300,39400,145000,100500,44500,425300,240300,25200,159800,432100,80700,351400,264600,45600,219000,112500,502400,143400,109900,249100
11/1/2014 0:00,Nov,2014,14-Nov,2640900,2137500,152600,106200,55300,50900,458400,84600,289700,84100,38800,145300,100700,44600,426200,240800,25200,160200,433200,81000,352200,264100,45800,218300,112700,503400,143500,110300,249600
12/1/2014 0:00,Dec,2014,14-Dec,2641300,2140200,152700,105700,55200,50500,459300,85100,289800,84400,38700,145500,100800,44700,427300,240900,25200,161200,434100,81100,353000,263900,45800,218100,113000,501100,143500,110200,247400
1/1/2015 0:00,Jan,2015,15-Jan,2642400,2140800,151800,105800,55400,50400,458800,84900,289400,84500,39200,145800,101100,44700,426600,240800,24800,161000,435200,81100,354100,264800,46300,218500,112800,501600,143500,110300,247800
2/1/2015 0:00,Feb,2015,15-Feb,2648100,2145300,153000,106000,55500,50500,459400,85000,289600,84800,38700,146000,101200,44800,427300,240900,24800,161600,436600,81400,355200,265200,45900,219300,113100,502800,143700,110400,248700
3/1/2015 0:00,Mar,2015,15-Mar,2643400,2142100,152300,105800,55500,50300,459500,85100,289600,84800,38500,146000,101100,44900,426800,241500,24800,160500,436700,81100,355600,263500,45400,218100,113000,501300,143800,110000,247500
4/1/2015 0:00,Apr,2015,15-Apr,2652800,2149900,153700,105500,55700,49800,461500,85300,290700,85500,38900,146100,101100,45000,429200,241600,24800,162800,438800,82500,356300,265400,45300,220100,110800,502900,143500,110500,248900
5/1/2015 0:00,May,2015,15-May,2663600,2159800,154900,105500,55600,49900,462900,85400,291600,85900,39300,145900,100900,45000,431700,242000,24700,165000,440600,82700,357900,267800,45500,222300,111200,503800,143100,111900,248800
6/1/2015 0:00,Jun,2015,15-Jun,2665700,2158900,155200,106000,56100,49900,464800,85600,292700,86500,38000,145900,100700,45200,430300,242200,24800,163300,440100,82500,357600,267500,45000,222500,111100,506800,143000,115100,248700
7/1/2015 0:00,Jul,2015,15-Jul,2668000,2166200,156100,106300,56200,50100,465200,86000,291800,87400,38800,145600,100200,45400,433200,242900,24800,165500,440600,82700,357900,268800,45300,223500,111600,501800,143800,109900,248100
8/1/2015 0:00,Aug,2015,15-Aug,2671300,2168100,157300,106500,56400,50100,464400,85700,291100,87600,38500,145300,99900,45400,433800,243400,24900,165500,441500,82900,358600,269000,45200,223800,111800,503200,144000,109600,249600
9/1/2015 0:00,Sep,2015,15-Sep,2670500,2165200,157600,106400,56300,50100,464400,85900,290700,87800,38200,144400,99000,45400,431600,242700,24800,164100,441400,83300,358100,269700,45500,224200,111500,505300,144400,109800,251100
10/1/2015 0:00,Oct,2015,15-Oct,2680300,2178200,159300,106400,56400,50000,466800,86100,291700,89000,38900,144500,99100,45400,436100,244900,24900,166300,444100,83500,360600,270200,45300,224900,111900,502100,144400,109500,248200
11/1/2015 0:00,Nov,2015,15-Nov,2681200,2178800,159800,106300,56300,50000,466000,86100,291500,88400,38600,144400,98800,45600,436900,244400,25000,167500,445100,83700,361400,269600,45000,224600,112100,502400,144900,109100,248400
12/1/2015 0:00,Dec,2015,15-Dec,2683500,2179500,160400,106600,56500,50100,465500,85900,290400,89200,38300,144000,98500,45500,436600,244000,24800,167800,444600,83300,361300,271200,45800,225400,112300,504000,145600,109500,248900
1/1/2016 0:00,Jan,2016,16-Jan,2684200,2181400,161300,105800,56000,49800,465400,85900,291600,87900,37900,143700,98300,45400,438200,244200,24900,169100,445400,83800,361600,270900,46100,224800,112800,502800,144700,109200,248900
2/1/2016 0:00,Feb,2016,16-Feb,2683700,2182100,160800,105600,55800,49800,467100,85900,292100,89100,38300,143600,98200,45400,437600,244700,25000,167900,445400,83900,361500,270700,45300,225400,113000,501600,144800,108900,247900
3/1/2016 0:00,Mar,2016,16-Mar,2687600,2184900,162200,105600,55800,49800,468400,85900,293300,89200,37800,143100,97600,45500,437500,244200,25000,168300,446000,84100,361900,271300,45500,225800,113000,502700,144900,109200,248600
4/1/2016 0:00,Apr,2016,16-Apr,2693200,2190400,162400,105700,55700,50000,467300,85900,291900,89500,38700,143800,98100,45700,440100,246500,25500,168100,447500,84400,363100,271800,45300,226500,113100,502800,145000,109200,248600
5/1/2016 0:00,May,2016,16-May,2688700,2187000,162300,105900,55800,50100,467200,85900,292000,89300,36100,143800,98100,45700,439700,245900,25500,168300,448300,84800,363500,270800,44700,226100,112900,501700,145100,108400,248200
6/1/2016 0:00,Jun,2016,16-Jun,2688600,2186500,162000,105600,55600,50000,466600,85800,291500,89300,38600,143700,98100,45600,439400,245100,25700,168600,446400,84900,361500,271700,45300,226400,112500,502100,145800,108200,248100
7/1/2016 0:00,Jul,2016,16-Jul,2696300,2194800,162700,105700,55600,50100,466700,85900,291300,89500,38600,143900,98200,45700,441500,246600,25700,169200,450900,85700,365200,271700,45500,226200,113100,501500,146300,108600,246600
8/1/2016 0:00,Aug,2016,16-Aug,2701600,2197700,162500,105700,55500,50200,467900,86000,291700,90200,38400,144200,98400,45800,442500,247100,25700,169700,450300,84800,365500,272900,45300,227600,113300,503900,146400,109700,247800
9/1/2016 0:00,Sep,2016,16-Sep,2709100,2203100,163100,106000,55700,50300,468700,86000,291900,90800,38300,144800,98500,46300,441900,246300,25700,169900,451900,85400,366500,274700,45300,229400,113700,506000,146500,108900,250600
10/1/2016 0:00,Oct,2016,16-Oct,2708600,2204200,163100,105900,55500,50400,468200,86100,291400,90700,37900,144900,98700,46200,442100,246300,25100,170700,452900,85600,367300,275500,45400,230100,113700,504400,146600,108800,249000
11/1/2016 0:00,Nov,2016,16-Nov,2712200,2208700,163000,106000,55500,50500,468500,85900,291100,91500,37900,144600,98400,46200,442500,246500,25300,170700,453600,85800,367800,279000,46100,232900,113600,503500,146500,109200,247800
12/1/2016 0:00,Dec,2016,16-Dec,2713900,2209400,163700,106100,55600,50500,467400,86000,290300,91100,37800,145100,98500,46600,442100,246200,25400,170500,454800,86200,368600,278700,45600,233100,113700,504500,146700,108400,249400
1/1/2017 0:00,Jan,2017,17-Jan,2720300,2215200,163600,106300,55700,50600,468600,86100,291300,91200,37900,145600,98700,46900,445100,247900,26200,171000,454700,86300,368400,279700,45400,234300,113700,505100,147000,109100,249000
2/1/2017 0:00,Feb,2017,17-Feb,2723700,2218400,165100,106500,55700,50800,468000,86100,290700,91200,38200,145500,98400,47100,444200,247300,26100,170800,456000,86600,369400,281100,45700,235400,113800,505300,147200,109000,249100
3/1/2017 0:00,Mar,2017,17-Mar,2722300,2216900,163900,106800,55900,50900,467200,86200,289700,91300,38100,145900,98600,47300,444000,247300,26000,170700,456500,86600,369900,280600,45700,234900,113900,505400,147100,109000,249300
4/1/2017 0:00,Apr,2017,17-Apr,2720100,2215700,163100,106800,55900,50900,467400,85900,289900,91600,37800,145900,98400,47500,443900,247500,25800,170600,457200,86700,370500,279900,45900,234000,113700,504400,147100,109200,248100
5/1/2017 0:00,May,2017,17-May,2721300,2215700,163200,106700,55800,50900,466800,85700,289200,91900,37600,145700,98000,47700,444500,247900,25800,170800,457800,86700,371100,279500,45700,233800,113900,505600,147200,110400,248000
6/1/2017 0:00,Jun,2017,17-Jun,2726500,2219800,163800,106800,55800,51000,467800,86200,289400,92200,37500,146400,98100,48300,445300,247900,25700,171700,458300,87000,371300,279500,46000,233500,114400,506700,147000,110900,248800
7/1/2017 0:00,Jul,2017,17-Jul,2727400,2222700,163400,106600,55800,50800,467600,86200,288800,92600,37200,147000,98000,49000,443400,247500,25600,170300,463800,91300,372500,279700,45700,234000,114000,504700,146600,110800,247300
8/1/2017 0:00,Aug,2017,17-Aug,2729400,2225100,163600,106600,55800,50800,467500,86200,289000,92300,37400,147100,97900,49200,444200,247900,25700,170600,464600,91500,373100,280200,46000,234200,113900,504300,146200,112100,246000
9/1/2017 0:00,Sep,2017,17-Sep,2727400,2224900,163300,106700,56000,50700,467700,86200,289000,92500,37300,146900,97700,49200,444400,247900,25700,170800,465000,91500,373500,279700,45800,233900,113900,502500,146500,109900,246100
10/1/2017 0:00,Oct,2017,17-Oct,2723100,2220100,163400,106400,55200,51200,467900,86200,288400,93300,36400,145700,96900,48800,443600,247100,25700,170800,467100,92800,374300,275800,44000,231800,113800,503000,146300,111600,245100
11/1/2017 0:00,Nov,2017,17-Nov,2727100,2223600,162300,107700,55800,51900,468100,86300,288300,93500,36300,146400,97100,49300,445500,247200,25700,172600,467600,93400,374200,275800,43300,232500,113900,503500,146000,111400,246100
12/1/2017 0:00,Dec,2017,17-Dec,2716100,2212700,161500,107600,56300,51300,465700,86200,286100,93400,36600,146000,97200,48800,442300,245300,25800,171200,467400,93100,374300,273000,42400,230600,112600,503400,145600,110600,247200
1/1/2018 0:00,Jan,2018,18-Jan,2730900,2227400,164000,107700,56100,51600,467500,86600,287700,93200,36400,145100,97200,47900,448800,246800,25700,176300,469900,93700,376200,274100,43300,230800,113900,503500,145200,110300,248000
2/1/2018 0:00,Feb,2018,18-Feb,2729900,2226300,165300,108500,56300,52200,469600,86600,289500,93500,36600,144200,96200,48000,444900,245600,25700,173600,469600,92700,376900,274800,43100,231700,112800,503600,144700,110300,248600
3/1/2018 0:00,Mar,2018,18-Mar,2733600,2230200,165200,108400,56200,52200,470400,85900,291000,93500,36500,143500,95500,48000,447700,245700,25600,176400,469200,92600,376600,276400,43300,233100,112900,503400,144400,110600,248400
4/1/2018 0:00,Apr,2018,18-Apr,2729400,2227900,164900,107700,56400,51300,470700,84700,291300,94700,36500,142600,94900,47700,447200,246500,26200,174500,468200,91900,376300,275800,42800,233000,114300,501500,144900,108000,248600
5/1/2018 0:00,May,2018,18-May,2737400,2233600,165600,108000,56500,51500,470600,84500,291800,94300,36500,141700,94300,47400,450500,249400,26500,174600,468000,92600,375400,278300,44600,233700,114400,503800,144300,110000,249500
6/1/2018 0:00,June,2018,18-Jun,2731900,2232100,166200,107700,56300,51400,469700,84300,290800,94600,36200,141100,94100,47000,453000,254100,26500,172400,468000,91500,376500,276400,42600,233800,113800,499800,144200,106400,249200
